NO textures/dlv_slateflr1e.xpm
SO textures/dlv_slateflr2e.xpm
WE textures/dlv_stonebrk2a.xpm
EA textures/dlv_stoneflr6c.xpm

C 150,200,100
F 3,64,200

    1111111
1111000000E11111
   1000000000011
    10000000000011
    101000010101001
    10100000000001
    101000011100011111
    10111111 11111
    101
    111
