NO textures/dlv_slateflr1e.xpm
SO textures/dlv_slateflr2e.xpm
WE textures/dlv_stonebrk2a.xpm
EA textures/dlv_stoneflr6c.xpm

C 150,200,100
F 3,64,200

        1111111111111111111111111
        1000000000110000000000001
        1011000001110000000000001
        1001000000000000000000001
111111111011000001110000000000001
100000000011000001110111111111111
11110111111111011100000010001
11110111111111011101010000001
11000000110101011100000010001
10000000000000001100000010001
10000000000000001101010010001
11000001110101011111011110N0011
11110111 1110101 101111010001
11111111 1111111 111111111111
