NO textures/tile_mud.xpm
   SO textures/tile_grass.xpm   
WE       textures/planks.xpm   	

C  	50,20,50


    		EA textures/brick_mud.xpm


F 50,70,70




1111111111
1000000001
1000100001
1E00000001
1000000001
1111111111
