NO textures/dlv_slateflr1e.xpm
   SO textures/dlv_slateflr2e.xpm   
WE       textures/dlv_stonebrk2a.xpm   	

C  	50,200,70


    		EA textures/dlv_stoneflr6c.xpm


F 50,60,100




1111111111
1000000001
1000100001
1E00000001
1000000001
1111111111
